############
#      ### #
#      ### #
#        # #
#   ###  # #
#   ###  # #
#   ###    #
############
