##########
#   #    #
# # ###  #
# #    # #
##  ## # #
#  # # # #
## # #   #
#    # # #
# #  # # #
##########