####################
#                  #
################## #
#                # #
# ############## # #
# #            # # #
# # ########## # # #
# # #        # # # #
# # # ###### # # # #
# # # #    # # # # #
# # # # #  # # # # #
# # # # #### # # # #
# # # #      # # # #
# # # ######## # # #
# # #          # # #
# # ############ # #
# #              # #
# ################ #
#                  #
####################
