###################
############    ###
############ ######
#########    ######
######### #########
######    #########
###### ############
###    ############
### ###############
#   ###############
### ###############
###    ############
###### ############
######    #########
######### #########
#########    ######
############ ######
############    ###
###################

