##############
#       ###  #
#       ###  #
#  ##        #
#       ###  #
#  ###  ###  #
#  ###       #
##############
