###########
#     ### #
#     ### #
#         #
#         #
#  ###    #
#  ###    #
###########
