############
#   #  #   #
#          #
# #    #   #
#    #     #
# #      # #
#    #     #
############