#################
#    #   #      #
#             # #
# #      #      #
#     #      #  #
#  #     #      #
#            #  #
# #    #        #
#    #      #   #
#################
