#################
# #  #   #      #
#      #   #  # #
# #  #   #      #
#   # #      #  #
# #      #      #
#    #       #  #
# #    #  #     #
#    #      #   #
#################
