##########
# #      #
# # #### #
#     #  #
# ### ## #
#        #
##########